%%%%%%%%%%%%%%%
% %    % %.   %
%  %%% % %%%% %
%%%   P  %    %
%  %%%%% %% %%%
%             %
%%%%%%%%%%%%%%%